Union Board -< grupo (correto Painel do Grupo)??
unit -≥ unidade
power grip -> pegada dupla (antes estava ambas as mãos)
Flash Strike -> Ataque Relâmpago (estava Ataque Lampejante)
formação Slash -> está Golpe de Chicote. Sugestão: Açoite
wing -> ala
tuck -> rapieira (estoque, em espanhol)
staff -> bastão, cetro
saber -> katana


parei na 4019
3039-57

2 x 2 h semana
220 mês
terça e quinta de 9 às 11h
Prof. Nox


status -> status
recipes - fórmulas
item arts - artes de itens (trocar por Artes de Objetos???)
Invocations - invocações
Evocations - evocações
Hexes - alterações
Remedies - remédios
Psionics - sortilégios
Wards - salvaguardas
PVs - PV
Lotions - loções (melhor unguentos???)
wield style - estilo de combate
Power grip - uma ou duas mãos???
quad wield - Quatro Mãos
dual power grip - Ambas as Mãos Sovani??? melhor pegada dupla???
Deadlock - embate (melhor duelo???)
Flank Attack - Ataque pelo Flanco
blades - lâminas
breakers - armas pesadas
mauling damage - danos por impacto
Spears and staves -  Lanças e bastões
polearms - armas de haste
bludgeoning - danos por contusão
piercing damage - danos por estocada
parry rate - índice de defesa
Critical Trigger - chance de ouro? ou ataques especiais?
Botch - desorientado
Acid Burn - Ácido?¿??
harvesting point - pontos de coleta
Digging Points - Pontos de Escavação
Felling Points - Pontos de Extração
Underwater Diving Points - Pontos de Perfuração
Mr. Diggs - Sr. Garras
Terrify Aura - Aura de Terror (em espanhol de Provocação)

mr.diggs _--------------------
Corkscrew - Saca-rolhas
Auger Drill - Broca
Diamond Drill - Broca de Diamante
Big Scoop - Grande Pá
Double Scoop - Pá Dupla
Triple Scoop - Pá Tripla
Search Adaptor - Adaptador de Busca
Analysis Adaptor - Adaptador de Prospecção
Telegnosis Adaptor - Adaptador de Radiestesia
Dig Module - Módulo Escavador
Mega Dig Module - Mega Módulo Escavador
Burst Dig Module - Hiper Módulo Escavador
Gold Digger - Escavador de Ouro
Platinum Digger - Escavador de Platina
Diamond Digger - Escavador de Diamante
Power Thruster - Propulsor
High-Power Thruster - Propulsor de Alta Potência
Hyper Thruster - Hiper Propulsor
Drill Storm - Tempestade Perfuradora
Mega Drill Storm - Mega Tempestade Perfuradora
Divine Drill Storm - Divina Tempestade Perfuradora

c





